7 14
|------------|
|.F.|..-.....|
|..-|.@P..-.F|
|.F....-.....|
|..|-....-...|
|..|.......-.|
|------------|